...........
...........
...........
...#####...
...#...#...
...#...#...
...#...#...
...##.##...
...........
...........
...........
