#...................................................
#...................................................
#...................................................
#...#############################################...
#...#...........................................#...
#...#...........................................#...
#...#...........................................#...
#...#...#####################################...#...
#...#...#...................................#...#...
#...#...#...................................#...#...
#...#...#...................................#...#...
#...#...#...#############################...#...#...
#...#...#...#...........................#...#...#...
#...#...#...#...........................#...#...#...
#...#...#...#...........................#...#...#...
#...#...#...#...#####################...#...#...#...
#...#...#...#...#...................#...#...#...#...
#...#...#...#...#...................#...#...#...#...
#...#...#...#...#...................#...#...#...#...
#...#...#...#...#...#############...#...#...#...#...
#...#...#...#...#...#...........#...#...#...#...#...
#...#...#...#...#...#...........#...#...#...#...#...
#...#...#...#...#...#...........#...#...#...#...#...
#...#...#...#...#...#...#####...#...#...#...#...#...
#...#...#...#...#...#...#...#...#...#...#...#...#...
#...#...#...#...#...#...#...#...#...#...#...#...#...
#...#...#...#...#...#...#...#...#...#...#...#...#...
#...#...#...#...#...#.......#...#...#...#...#...#...
#...#...#...#...#...#.......#...#...#...#...#...#...
#...#...#...#...#...#########...#...#...#...#...#...
#...#...#...#...#...............#...#...#...#...#...
#...#...#...#...#...............#...#...#...#...#...
#...#...#...#...#...............#...#...#...#...#...
#...#...#...#...#################...#...#...#...#...
#...#...#...#.......................#...#...#...#...
#...#...#...#.......................#...#...#...#...
#...#...#...#.......................#...#...#...#...
#...#...#...#########################...#...#...#...
#...#...#...............................#...#...#...
#...#...#...............................#...#...#...
#...#...#...............................#...#...#...
#...#...#################################...#...#...
#...#.......................................#...#...
#...#.......................................#...#...
#...#.......................................#...#...
#...#########################################...#...
#...............................................#...
#...............................................#...
#...............................................#...
#################################################...
