#...........................
#...........................
#...#####################...
#...#...................#...
#...#...................#...
#...#...................#...
#...#...#############...#...
#...#...#...........#...#...
#...#...#...........#...#...
#...#...#...........#...#...
#...#...#...#####...#...#...
#...#...#...#...#...#...#...
#...#...#...#...#...#...#...
#...#...#...#...#...#...#...
#...#...#.......#...#...#...
#...#...#.......#...#...#...
#...#...#########...#...#...
#...#...............#...#...
#...#...............#...#...
#...#...............#...#...
#...#################...#...
#.......................#...
#.......................#...
#.......................#...
#########################...
............................
............................
............................
